1111111111111111
1P00000000000001
10C00000E0000001
1000000000000001
1111111111111111
