111111111111111111111111111111
10E000000000000C00000C00000001
100000000000000000000000000001
100000000000000000000000000001
100P00000C00C00000000000000001
111111111111111111111111111111