11111111111111111111111111
1E0000000000000C00000C0001
10100100000000100010010001
1P0000000C00C0000000000001
11111111111111111111111111