111111111111111111111
1000000001010000000E1
1000000P0000000000001
1000000000000010000P1
111111111111111111111