111111111111111111111
1000000001E1000000001
1000000000000P00C0C01
100C000C0000000000001
111111111111111111111