11111111111111111111111111111
10000000000000000000000000001
100P00000000000000000000000E1
100000000C0000000000000000001
10000000000000000000000000001
100000000000C0000000000000001
10000000000000000000000000001
10000000000000000000000000001
100000000000C0000000000000001
10000000000000000000000000001
11111111111111111111111111111