1111111111111
1P00000000001
10C00000E0001
1111111111111