1111111111
1P00000001
10C00000E1
1111111111