111111111
100E000C1
1000P0001
111111111