11111111111
1C0000CC101
11111100011
10000000001
1E00P101001
10101100101
100CCC01C01
11111111111